1111111111111111111111111111111111111111111111111111111111111111111111111111111111111111111111111111111111111111111111
1210001111111111111111111111111111111111111111111111111111111111111111111111111111111111111111111111111111111111111111
1010131111111111111111111111111111111111111111111111111111111111111111111111111111111111111111111111111111111111111111
1000101110000000000001111111111111111111111111111111111111111111111111111111111111111111111111111111111111111111111111
1011101110111111111101111111111111111111111111111111111111111111111111111111111111111111111111111111111111111111111111
1411100000111111111101111111111111111111111111111111111111111111111111111111111111111111111111111111111111111111111111
1111111110300000000000000000000000001111111111111111111111111111111111111111111111111111111111111111111111111111111111
1111111111111111111111111110111111101111111111111111111111111111111111111111111111111111111111111111111111111111111111
1111111111111111111111111110111111131111111111111111111111111111111111111111111111111111111111111111111111111111111111
1111111111111111111111400000111111101111111111111111111111111111111111111111111111111111111111111111111111111111111111
1111111111111111111111111111111111101111111111111111111111111111111111111111111111111111111111111111111111111111111111
1111111111111111111111111111111111100000000000001111111111111111111111111111111111111111111111111111111111111111111111
1111111111111111111111111111111111111111111111101111111111111111111111111111111111111111111111111111111111111111111111
1111111111111111111111111111000000011111111111101111111111111111111111111111111111111111111111111111111111111111111111
1111111111000000000000000000011111000000000000001111111111111111111111111111111111111111111111111111111111111111111111
1111111111011111111111111111111111111111111111111111111111111111111111111111111111111111111111111111111111111111111111
1111111111000000001111111111111111111111111111111111111111111111111111111111111111111111111111111111111111111111111111
1111111111111111101111111111111111111111111111111111111111111111111111111111111111111111111111111111111111111111111111
1111111111111111101111111111111111111111111111111111111111111111111111111111111111111111111111111111111111111111111111
1111111111111111100000000000000000000000000000000000000000000001111111111111111111111111111111111111111111111111111111
1111111111111111111111111111111111111111111111111111111111111100000000000000000005111111111111111111111111111111111111
1111111111111111111111111111111111111111111111111111111111111111111111111111111111111111111111111111111111111111111111
